###############################
#                             #
#  ################  #  #  #  #
#        #           #  #  #  #
####  #######  ##########  #  #
#           #     #        #  #
#######  #######  #############
#  #           #  #           #
#  #######  ####  ####  ####  #
#              #        #  #  #
####  #  ####  ##########  #  #
#     #  #     #        #  #  #
#  #  #  #  ##########  #  #  #
#  #  #  #     #        #  #  #
#  #######  #  #  #######  #  #
#        #  #        #        #
####  #######  ####  #  #  ####
#     #  #        #  #  #     #
#  ####  ####  #  #  #  ####  #
#        #     #  #  #  #     
############################  

