####################################################
#  #  #  #                       #              #  #
#  #  #  #  ####  #  #  #######  #  ####  #  ####  #
#  #           #  #  #        #        #  #        #
#  ####  ####  #############  ####  ####  #  #######
#  #     #  #     #        #     #  #     #        #
#  #  ####  #  ####  ############################  #
#        #     #     #  #        #     #           #
#######  #######  ####  #  #  #  ####  #############
#  #  #     #              #  #  #     #  #  #     #
#  #  ####  #  ##########  #  #  #  ####  #  #  ####
#     #     #           #  #  #  #  #        #  #  #
#  ####  #  #  #  #######  #  ####  #  #######  #  #
#  #  #  #     #  #  #     #        #           #  #
#  #  #  #######  #  #  #######  ####  #  #######  #
#        #           #     #     #  #  #  #        #
#  #######  ####  ####  ####  #  #  ####  ####  ####
#     #     #  #  #  #  #  #  #     #     #  #     #
#  #  #  #  #  #  #  #  #  #  #  #######  #  #  #  #
#  #  #  #  #        #  #  #  #  #  #           #  #
#######  #  ####  ####  #  #######  #  #  #  #######
#     #  #     #  #  #  #     #  #  #  #  #  #     #
#  ####  ####  ####  #  #  ####  #  #######  ####  #
#           #  #  #     #  #  #     #  #           #
#  ####  #######  #######  #  ####  #  #  ##########
#  #        #     #  #        #           #  #     #
#  #  ####  #  ####  ####  ####  ##########  #  #  #
#  #     #           #     #                    #  #
####  #  #  #  ##########  #  #  #######  #  ####  #
#     #  #  #  #     #  #     #     #     #     #  #
#  ##########  ####  #  #  #############  #  ####  #
#        #  #  #     #  #     #           #  #  #  #
#  #  ####  #  #  ####  #############  #######  #  #
#  #     #                                #        
#################################################  
